{
    "row":9,
    "col":9,
    "cells":[
                0,1,1,1,1,1,1,1,0,
                1,0,1,1,1,1,1,0,1,
                1,1,0,1,1,1,0,1,1,
                1,1,1,0,1,0,1,1,1,
                1,1,1,1,0,1,1,1,1,
                1,1,1,0,1,0,1,1,1,
                1,1,0,1,1,1,0,1,1,
                1,0,1,1,1,1,1,0,1,
                0,1,1,1,1,1,1,1,0
             ]
}
